01010001010
00010101000
01111100101
01000101100
01010001010
00001110000
10101000110
00100010100
10011120001
00100011100
10001000110
